################
#P    #       D#
# ###### #######
#      #       #
###### # #### ##
#      #    #  #
# ###### ## # ##
#   S      #   #
################
