####################
#P#   #        #  D#
# # ### ####### # ##
# #   #     #   #  #
# ### ##### # ### ##
#   #     # #   #  #
### # ### # ### # ##
#   #   # #     #  #
# ##### # ####### ##
#       #   S     ##
####################
