#########################
#  # #  #   ####    #  ##
# P#  ### # ## # ####   #
#     # ## #####  #######
#   #  ## ### #     #####
# #### #  # ###     #####
#  #### ####### ##### # #
#           S          ##
## #   #   ## ### #  # ##
#  ####   #######    # ##
#    ##    ## # ###### ##
###### #### # #  # ### ##
#  #        ### #  ###D##
#   ##     ##############
#########################