###############################
## ###      #####   # #   ### #
# ## ## #  ##  ##   # ##  ##  #
# P  # #   ## ## # # ## #### ##
# #   #   ##  ###  #     # ## #
# #  #  ### # #####   ##     ##
#  ##  #       # #  #  ########
#  #     ##  # ## # ##  #    ##
#              S             ##
#   #   ###    #        ###  ##
#   ### #     ##    # ###     #
# #        ########  ## #  # ##
###  # ## #######   ###### # ##
# #########    # ##   ##  ##D #
# #####  ##### ##   ###   ##  #
##   # ##   ######  ##    # ###
###############################