###################################
#  # #  # #    #### ##  # # #  #  #
# P #    #####  ##     ### # ## ###
#  #       # #  #### ## # ## #  # #
#     #  #  ##   ## ####    #  #  #
#  ##  ## #   #####      ## #  #  #
#    ##    # ##### ###   ## # ## ##
#    #  #   # #### #   # ##  # ## #
#    #   ##### # #   ### ## #     #
#  #    ##  #  ### #### # ## ## # #
#                S               ##
# ## ##     ##   ### ##  # #      #
##   ##   ##  #  #  #### # ###  ###
# # #  ##  #  # ##    #####   #   #
# #   ### #     ##   #  # ##     ##
#  ##  ##  # ### ## # #   ##      #
##  ##       ## ## # #  #  # ## # #
## # ###  # #   ##  # #   #  # D###
#  ##          # ###   ###  ##  # #
###    # #### # ##  ##    #   ## ##
###################################