###########
#         #
# 1     g #
#         #
#   ###   #
#         #
#         #
###########