#####################
# 2   #       #     #
#                   #
### # ### ### # ### #
#   #   #   #   #   #
# ##### # ### ### ###
#     # #     #     #
### ### ##### ### ###
#   #     #   #   # #
# ### ### # ### # # #
#   #   # #   # #   #
# ### # ### ### ##### 
#     #     #       #
##### ### ### ##### #
#     #   #   #     #
# ### ### # ### ### #
#   #     #     # g #
#                   #
#####################